LABEL
     ACTCAP    = 'F_JOB_WRK_ACTIVITY_PRIM_SEC_COMPUTER '
     ACTDED    = 'F_JOB_WRK_ACTIVITY_PRIM_SEC_DEV_DESIGN '
     ACTMGT    = 'F_JOB_WRK_ACTIVITY_PRIM_SEC_MGT_SALES '
     ACTRD     = 'F_JOB_WRK_ACTIVITY_PRIM_SEC_RSRCH_DEV '
     ACTRES    = 'F_JOB_WRK_ACTIVITY_PRIM_SEC_RSRCH '
     ACTRDT    = 'F_JOB_WRK_ACTIVITY_PRIM_SEC_RSRCH_DEV_TEACH '
     ACTTCH    = 'F_JOB_WRK_ACTIVITY_PRIM_SEC_TEACH '
     FSAGR     = 'I_JOB_GOV_AGCY_SUPP_AGRIC '
     FSDOD     = 'I_JOB_GOV_AGCY_SUPP_DEFENSE '
     FSDK      = 'I_JOB_GOV_AGCY_SUPPORT_DONT_KNOW '
     FSDED     = 'I_JOB_GOV_AGCY_SUPP_EDUC '
     FSDOE     = 'I_JOB_GOV_AGCY_SUPP_ENERGY '
     FSEPA     = 'I_JOB_GOV_AGCY_SUPP_EPA '
     FSHHS     = 'I_JOB_GOV_AGCY_SUPP_HHS '
     FSNASA    = 'I_JOB_GOV_AGCY_SUPP_NASA '
     FSNIH     = 'I_JOB_GOV_AGCY_SUPP_NIH '
     FSNSF     = 'I_JOB_GOV_AGCY_SUPP_NSF '
     FSOT      = 'I_JOB_GOV_AGCY_SUPP_OTHR '
     FSDOT     = 'I_JOB_GOV_AGCY_SUPP_TRANSPORT '
     AGEP      = 'U_DEM_AGE_PUB '
     PROMTGI   = 'D_JOB_PROF_ASSOC_ATTEND_MTNGS_IND '
     WTRSKL    = 'G_JOB_TRAINING_REAS_ACQ_SKILL '
     WTRADV    = 'G_JOB_TRAINING_REAS_ADVANCEMT '
     WTRCHG    = 'G_JOB_TRAINING_REAS_CHG_OCCUPAT '
     WTREM     = 'G_JOB_TRAINING_REAS_EMPLR_REQ '
     WTRLIC    = 'G_JOB_TRAINING_REAS_LICENSING '
     WTRSN     = 'G_JOB_TRAINING_REAS_PRIMRY '
     WTRNEW    = 'G_JOB_TRAINING_REAS_NEW_POS '
     WTROT     = 'G_JOB_TRAINING_REAS_OTHR '
     BAAYR5P   = 'J_ED_BA_DEGREE_AWARD_YR_5_YR_GROUPING_PUB '
     BAMEDP    = 'J_ED_BA_MAJOR_ED_CAT_PUB '
     BAMEMG    = 'J_ED_BA_MAJOR_ED_GROUP_MAJOR '
     BTHUS     = 'U_DEM_BIRTH_PLACE_REGION_US_NONUS '
     CHTOTPB   = 'W_DEM_CHILDREN_TOTAL_PUB '
     CHUN12    = 'W_DEM_CHILDREN_UNDER_12_IND '
     CCAFDG    = 'N_ED_SINCE_MR_ENROLL_IND '
     CCEP      = 'N_ED_MR_EMP_ASSISTANCE '
     WRKG      = 'A_JOB_STATUS_EMPLOYED_IND '
     WRKGP     = 'D_JOB_EMPLOYED_IND '
     EMSECPB   = 'E_JOB_EMPLR_SECTOR_CD_PUB '
     EMSIZE    = 'E_JOB_EMPLR_SIZE '
     FACTEN    = 'E_JOB_EMPLR_EDUC_INST_TENURE_RANK '
     FPTIND    = 'A_JOB_STATUS_FULL_PART_TIME '
     GENDER    = 'U_DEM_GENDER '
     GOVSUP    = 'I_JOB_GOV_AGCY_SUPPORT_IND '
     HDAY5P    = 'O_ED_HD_DEGREE_AWARD_YR_5_YR_GROUPING_PUB '
     DGRDG     = 'O_ED_HD_DEGREE_TYPE '
     DGRMEDP   = 'O_ED_HD_MAJOR_ED_CAT_PUB '
     DGRMEMG   = 'O_ED_HD_MAJOR_ED_GRP_MAJOR '
     EMBUS     = 'E_JOB_EMPLR_BUSINESS '
     NEWBUS    = 'E_JOB_EMPLR_NEW_BUSINESS '
     PHDPAJB   = 'D_JOB_PHD_CAREER_PATH_JOB '
     ADQCOMM   = 'D_JOB_PHD_CAREER_PREPARE_COMMUNICATION '
     ADQCOMP   = 'D_JOB_PHD_CAREER_PREPARE_COMPUTER '
     ADQCONT   = 'D_JOB_PHD_CAREER_PREPARE_CONTACTS '
     ADQETHIC  = 'D_JOB_PHD_CAREER_PREPARE_ETHICS '
     ADQKNOW   = 'D_JOB_PHD_CAREER_PREPARE_KNOWLEDGE '
     ADQMNG    = 'D_JOB_PHD_CAREER_PREPARE_MANAGEMENT '
     ADQNONE   = 'D_JOB_PHD_CAREER_BETTER_PREPARE_NONE '
     ADQPRI    = 'D_JOB_PHD_CAREER_BETTER_PREPARE_PRIMARY_AREA '
     ADQGP     = 'D_JOB_PHD_CAREER_PREPARE_PROBLEM_SOLVING '
     ADQQUA    = 'D_JOB_PHD_CAREER_PREPARE_QUANTITATIVE '
     PHDSATIS  = 'D_JOB_PHD_CAREER_PROGRAM_SATISFIED '
     ADQSEC    = 'D_JOB_PHD_CAREER_BETTER_PREPARE_SECONDARY_AREA '
     ADQTEACH  = 'D_JOB_PHD_CAREER_PREPARE_TEACHING '
     ADQTEAM   = 'D_JOB_PHD_CAREER_PREPARE_TEAM_WORK '
     ADQWRITE  = 'D_JOB_PHD_CAREER_PREPARE_WRITING '
     PHDDEBT   = 'D_JOB_PHD_CAREER_PATH_LIMITED_DEBT '
     PHDFAM    = 'D_JOB_PHD_CAREER_PATH_LIMITED_FAMILY '
     PHDNA     = 'D_JOB_PHD_CAREER_PATH_LIMITED_NO_JOB '
     PHDPTHO   = 'D_JOB_PHD_CAREER_PATH_LIMITED_OTHER '
     PHDSP     = 'D_JOB_PHD_CAREER_PATH_LIMITED_SPOUSE '
     PATHMOS   = 'D_JOB_PHD_CAREER_PATH_MONTHS_ELAPSED '
     PHDMOVE   = 'D_JOB_PHD_CAREER_PATH_LIMITED_RELOCATE '
     PATHDC    = 'D_JOB_PHD_CAREER_PATH_RESOURCES_DIRECT_CONTACTS '
     PATHEP    = 'D_JOB_PHD_CAREER_PATH_RESOURCES_ELECTRONIC '
     PATHFA    = 'D_JOB_PHD_CAREER_PATH_RESOURCES_FACULTY '
     PATHIC    = 'D_JOB_PHD_CAREER_PATH_RESOURCES_INFORMAL '
     PATHPJ    = 'D_JOB_PHD_CAREER_PATH_RESOURCES_JOURNALS '
     PATHPM    = 'D_JOB_PHD_CAREER_PATH_RESOURCES_MEETINGS '
     PATHNP    = 'D_JOB_PHD_CAREER_PATH_RESOURCES_NEWSPAPERS '
     PATHNA    = 'D_JOB_PHD_CAREER_PATH_RESOURCE_NA '
     PATHOT    = 'D_JOB_PHD_CAREER_PATH_RESOURCES_OTHER '
     PATHPO    = 'D_JOB_PHD_CAREER_PATH_RESOURCES_PLACEMENT '
     PATHPRI   = 'D_JOB_PHD_CAREER_PATH_RESOURCE_PRIMARY '
     PATHPR    = 'D_JOB_PHD_CAREER_PATH_RESOURCES_RECRUITERS '
     PATHSEC   = 'D_JOB_PHD_CAREER_PATH_RESOURCE_SECONDARY '
     PHDRCNT   = 'D_JOB_PHD_RECENT '
     LFSTAT    = 'A_JOB_STATUS_LABOR_FORCE_STAT '
     LOOKWK    = 'A_JOB_STATUS_LOOKING_FOR_WRK_IND '
     OCMLST    = 'C_JOB_LAST_OCC_GRP_MAJOR '
     MINRTY    = 'U_DEM_RACE_MINORITY_IND '
     MR5YRP    = 'M_ED_MR_DEGREE_AWARD_YR_5_YR_GROUPING_PUB '
     MRDG      = 'M_ED_MR_DEGREE_TYPE '
     MRMEDP    = 'M_ED_MR_MAJOR_ED_CAT_PUB '
     MRMEMG    = 'M_ED_MR_MAJOR_ED_GRP_MAJOR '
     NWFAM     = 'A_JOB_NOT_WRKNG_REAS_FAMILY '
     NWILL     = 'A_JOB_NOT_WRKNG_REAS_ILL_DISABLE '
     NWLAY     = 'A_JOB_NOT_WRKNG_REAS_LAYOFF '
     NWOCNA    = 'A_JOB_NOT_WRKNG_REAS_JOB_NOT_AVAIL '
     NWNOND    = 'A_JOB_NOT_WRKNG_REAS_NO_NEED '
     NWOT      = 'A_JOB_NOT_WRKNG_REAS_OTHR '
     NWRET     = 'A_JOB_NOT_WRKNG_REAS_RETIRED '
     NWSTU     = 'A_JOB_NOT_WRKNG_REAS_STUDENT '
     CH1217IN  = 'W_DEM_CHILDREN_IND_12_17 '
     CH18IN    = 'W_DEM_CHILDREN_IND_18 '
     CH25IN    = 'W_DEM_CHILDREN_IND_2_5 '
     CH611IN   = 'W_DEM_CHILDREN_IND_6_11 '
     CHU2IN    = 'W_DEM_CHILDREN_IND_UNDER_2 '
     CH6IN     = 'W_DEM_CHILDREN_IND_UNDER_6 '
     NRCHG     = 'B_JOB_OUTSIDE_FLD_REAS_CAREER_CHG '
     NRFAM     = 'B_JOB_OUTSIDE_FLD_REAS_FAMILY '
     NRLOC     = 'B_JOB_OUTSIDE_FLD_REAS_LOC '
     NRREA     = 'B_JOB_OUTSIDE_FLD_REASON_PRIMRY '
     NROCNA    = 'B_JOB_OUTSIDE_FLD_REAS_JOB_NOT_AVAIL '
     NROT      = 'B_JOB_OUTSIDE_FLD_REAS_OTHR '
     NRPAY     = 'B_JOB_OUTSIDE_FLD_REAS_PAY_OR_PROMOT '
     NRSEC     = 'B_JOB_OUTSIDE_FLD_REASON_SECOND '
     NRCON     = 'B_JOB_OUTSIDE_FLD_REAS_WRKNG_CONDS '
     PTFAM     = 'C_JOB_PT_REAS_FAMILY '
     PTILL     = 'C_JOB_PT_REAS_ILL_DISABLE '
     PTOCNA    = 'C_JOB_PT_REAS_JOB_NOT_AVAIL '
     PTNOND    = 'C_JOB_PT_REAS_NO_NEED '
     PTOT      = 'C_JOB_PT_REAS_OTHR '
     PTRET     = 'C_JOB_PT_REAS_RETIRED '
     PTSTU     = 'C_JOB_PT_REAS_STUDENT '
     PTWTFT    = 'A_JOB_PT_WANT_FULL_TIME '
     FTPRET    = 'B_JOB_RETIRED_PREVLY_IND '
     PFMAEDGR  = 'N_ED_SINCE_MR_ENROLL_ED_GRP_MAJOR '
     OCPRPB    = 'B_JOB_CAT_PUB '
     OCPRMG    = 'B_JOB_OCC_GRP_MAJOR '
     OCEDRLP   = 'B_JOB_RELTD_TO_DEGREE '
     WKSWKP    = 'B_PRINCIPAL_JOB_WEEKS_PUB '
     HRSWKP    = 'B_PRINCIPAL_JOB_WKLY_HRS_PUB '
     PRMBRPB   = 'D_JOB_PROF_ASSOC_MEMBRSHPS_NBR_PUB '
     RACETHP   = 'U_DEM_RACE_ETHNICITY_CAT_PUB '
     SALARP    = 'H_JOB_SALARY_ANN_PUB '
     EMSMI     = 'D_JOB_SAME_EMPLOYER_JOB '
     OCSI      = 'C_JOB_2ND_JOB_IND '
     OCSMG     = 'C_JOB_2ND_JOB_OCC_GRP_MAJOR '
     OCSEDRL   = 'C_JOB_2ND_JOB_RELTD_TO_DEGREE '
     SUPWK     = 'F_JOB_SUPERVISE_WRK_IND '
     SURID     = 'Z_SURVEY_IDENTIFIER '
     REFYR     = 'Z_SURVEY_YEAR '
     TCADV     = 'N_ED_SINCE_MR_ENROLL_REAS_ADVANCEMT '
     TCCAR     = 'N_ED_SINCE_MR_ENROLL_REAS_BEGIN_CAREER '
     TCCHG     = 'N_ED_SINCE_MR_ENROLL_REAS_CHG_FLD '
     TCEM      = 'N_ED_SINCE_MR_ENROLL_REAS_EMPR_REQ '
     TCSKL     = 'N_ED_SINCE_MR_ENROLL_REAS_ACQ_SKILL '
     TCLIC     = 'N_ED_SINCE_MR_ENROLL_REAS_LICENSING '
     TCOT      = 'N_ED_SINCE_MR_ENROLL_REAS_OTHR '
     TCINT     = 'N_ED_SINCE_MR_ENROLL_REAS_PERSONL '
     TCGRD     = 'N_ED_SINCE_MR_ENROLL_REAS_PREP_GRAD_SCHL '
     MGRNAT    = 'F_JOB_MGR_TECH_EXPERTSE_PHYS_SCI '
     MGROTH    = 'F_JOB_MGR_TECH_EXPERTSE_OTHER '
     MGRSOC    = 'F_JOB_MGR_TECH_EXPERTSE_SOCIAL_SCI '
     CTZUSIN   = 'V_DEM_CITIZENSHIP_US_CITIZEN '
     WTSURVY   = 'Z_WEIGHTING_FACTOR_SURVEY '
     WAACC     = 'F_JOB_WRK_ACTVTY_ACCTNG '
     WAAPRSH   = 'F_JOB_WRK_ACTVTY_APPLIED_RSCH '
     WABRSH    = 'F_JOB_WRK_ACTVTY_BASIC_RSCH '
     WACOM     = 'F_JOB_WRK_ACTVTY_COMPUTER '
     WADSN     = 'F_JOB_WRK_ACTVTY_DESIGN '
     WADEV     = 'F_JOB_WRK_ACTVTY_DEVELOPMT '
     WAEMRL    = 'F_JOB_WRK_ACTVTY_PERSONNEL '
     WAMGMT    = 'F_JOB_WRK_ACTVTY_MGT '
     WAOT      = 'F_JOB_WRK_ACTVTY_OTHR '
     WAPRI     = 'F_JOB_WRK_ACTIVITY_PRIMRY '
     WAPRSM    = 'F_JOB_WRK_ACTIVITY_PRIMRY_SUMRY '
     WAPROD    = 'F_JOB_WRK_ACTVTY_PRODUCTN '
     WASVC     = 'F_JOB_WRK_ACTVTY_PROF_SERV '
     WAQM      = 'F_JOB_WRK_ACTVTY_QUAL_MGT '
     WASALE    = 'F_JOB_WRK_ACTVTY_SALES '
     WASEC     = 'F_JOB_WRK_ACTIVITY_SECONDARY '
     WASCSM    = 'F_JOB_WRK_ACTIVITY_SECONDARY_SUMRY '
     WATEA     = 'F_JOB_WRK_ACTVTY_TEACH '
     TCDGCMP   = 'N_ED_WORK_DEGREE_COMPLETED '
     WTAPRF    = 'G_JOB_TRAINING_WRK_RELTD_GENL '
     WKTRNI    = 'G_JOB_TRAINING_WRK_RELTD_IND '
     WTMGT     = 'G_JOB_TRAINING_WRK_RELTD_MGT '
     WTOT      = 'G_JOB_TRAINING_WRK_RELTD_OTHR '
     WTTECH    = 'G_JOB_TRAINING_WRK_RELTD_TECHNCL '
   ;
